1111111111111
1C1100E0000C1
1110011111001
1P0011C000011
1111111111111